...#....G
.###.###.
.......#.
######.##
.#.......
.#.#.####
.#.#.....
.#.#####.
S........