...#....G
..##..##.
.......#.
######.##
.#.......
.#....###
.#.#.....
...####..
S........