...#....G
.###.###.
.........
######.#.
.#.....#.
.#.#.###.
.#.#.....
.#.#####.
S........